R    1444  3000

S    ./textures/mushroom.xpm

NO     ./textures/NO.xpm
SO     ./textures/SO.xpm

C  50,   30 ,   110
WE ./textures/WE.xpm

F 15 ,   100 ,   20




EA     ./textures/EA.xpm
                            111111111111111111111
                              101101010000000001
                               11100002000000001
                                10000000000000001
                               1100000000000000001
                              1002000000000000001
                              100000000010001111
                             101100110010111101
                            10000000000010000001
                           11000N000000000000001
                          100000000020001001000011
                          1001000100010000001011
                           1111111111111111111
