R 9999 9999
S  ./textures/barrel.xpm
WE ./textures/WE.xpm
SO ./textures/SO.xpm
EA ./textures/EA.xpm
NO ./textures/NO.xpm

F 120,30,000
C 020,0,10


111111111111111
110200020000011
121000000000001
120000000000001
100000000000001
111111000111111
100000100000001
111111000111011
111111000111111
100000010000001
111111010111111
1000000000000011
12000000000021101
11111111111111111


  