NO ./parcing/textures/NO.xpm

SO ./parcing/textures/SO.xpm
EA ./parcing/textures/EA.xpm
R 1080 0920
WE ./parcing/textures/WE.xpm

S ./parcing/textures/mushroom.xpm


F 120,30,000
C 020,0,10


              111111111111111
              110200020011111
              11111S000000001
              121110000000001
11111111111111100000000111111
111111000111111111111111
100000100000001
111111000111011
111111000111111
100000010000001
111111010111111
1000000000000011
12000000000021101
11111111111111111


  